+------------------------------------------------------------------------------+
|   ┌─────────────────────────────────┴──┴─────────────────────────────────┐   |
|   │                                                                      │   |
|   │                                                                      │   |
|   │                                                                      │   |
|   │                                                                      │   |
|   │                                                                      │   |
|   │                                                                      │   |
| ──┤                                                                      ├── |
| ──┤                                                                      ├── |
|   │                                                                      │   |
|   │                                                                      │   |
|   │                                                                      │   |
|   │                                                                      │   |
|   │                                                                      │   |
|   │                                                                      │   |
|   └─────────────────────────────────┬──┬─────────────────────────────────┘   |
+------------------------------------------------------------------------------+